Country,Confirmed,Deaths,Recovered,Active,New Cases,Deaths / 100 Cases,Recovered / 100 Cases,Deaths / 100 Recovered,Population,Cases / Million People,Confirmed last week,1 week change,1 week % increase
Afghanistan,151770,7000,0,144770,0,4.61,0.0,0.0,38928341,3899.0,149810,1960,1.31
Albania,135947,2464,0,133483,397,1.81,0.0,0.0,2877800,47240.0,133912,2035,1.52
Algeria,187258,4794,0,182464,603,2.56,0.0,0.0,43851043,4270.0,181376,5882,3.24
Andorra,14924,129,0,14795,0,0.86,0.0,0.0,77265,193153.0,14836,88,0.59
Angola,44617,1100,0,43517,83,2.47,0.0,0.0,32866268,1358.0,43662,955,2.19
Antigua and Barbuda,1397,43,0,1354,19,3.08,0.0,0.0,97928,14266.0,1338,59,4.41
Argentina,5084635,109041,0,4975594,3727,2.14,0.0,0.0,45195777,112502.0,5018895,65740,1.31
Armenia,234558,4695,0,229863,331,2.0,0.0,0.0,2963234,79156.0,232157,2401,1.03
Australia,39615,966,0,38649,518,2.44,0.0,0.0,50919400,778.0,36630,2985,8.15
Austria,668732,10756,0,657976,891,1.61,0.0,0.0,9006400,74251.0,663082,5650,0.85
Azerbaijan,368002,5153,0,362849,2993,1.4,0.0,0.0,10139175,36295.0,351825,16177,4.6
Bahamas,16141,311,0,15830,0,1.93,0.0,0.0,393248,41045.0,15537,604,3.89
Bahrain,270919,1384,0,269535,103,0.51,0.0,0.0,1701583,159216.0,270060,859,0.32
Bangladesh,1418902,24175,0,1394727,6684,1.7,0.0,0.0,164689383,8616.0,1353695,65207,4.82
Barbados,4525,48,0,4477,0,1.06,0.0,0.0,287371,15746.0,4471,54,1.21
Belarus,461303,3604,0,457699,1305,0.78,0.0,0.0,9449321,48819.0,453932,7371,1.62
Belgium,1149869,25287,0,1124582,0,2.2,0.0,0.0,23021022,49949.0,1136726,13143,1.16
Belize,14847,344,0,14503,0,2.32,0.0,0.0,397621,37340.0,14438,409,2.83
Benin,9065,113,0,8952,0,1.25,0.0,0.0,12123198,748.0,8608,457,5.31
Bhutan,2571,3,0,2568,1,0.12,0.0,0.0,771612,3332.0,2544,27,1.06
Bolivia,482428,18185,0,464243,797,3.77,0.0,0.0,11673029,41328.0,477696,4732,0.99
Bosnia and Herzegovina,207076,9701,0,197375,0,4.68,0.0,0.0,3280815,63117.0,206106,970,0.47
Botswana,136758,1973,0,134785,0,1.44,0.0,0.0,2351625,58155.0,122574,14184,11.57
Brazil,20364099,569058,0,19795041,13957,2.79,0.0,0.0,422706534,48176.0,20165672,198427,0.98
Brunei,723,3,0,720,83,0.41,0.0,0.0,437483,1653.0,347,376,108.36
Bulgaria,433234,18344,0,414890,272,4.23,0.0,0.0,6948445,62350.0,428049,5185,1.21
Burkina Faso,13675,170,0,13505,4,1.24,0.0,0.0,20903278,654.0,13621,54,0.4
Burma,354279,13263,0,341016,2674,3.74,0.0,0.0,54409800,6511.0,329516,24763,7.51
Burundi,9620,38,0,9582,0,0.4,0.0,0.0,11890781,809.0,8088,1532,18.94
Cabo Verde,34397,300,0,34097,53,0.87,0.0,0.0,555988,61866.0,34052,345,1.01
Cambodia,85448,1683,0,83765,588,1.97,0.0,0.0,16718971,5111.0,81891,3557,4.34
Cameroon,82454,1338,0,81116,0,1.62,0.0,0.0,26545864,3106.0,82064,390,0.48
Canada,1459070,26657,0,1432413,744,1.83,0.0,0.0,75750184,19262.0,1446497,12573,0.87
Central African Republic,11251,99,0,11152,0,0.88,0.0,0.0,4829764,2330.0,7151,4100,57.33
Chad,4982,174,0,4808,0,3.49,0.0,0.0,16425859,303.0,4978,4,0.08
Chile,1629192,36380,0,1592812,899,2.23,0.0,0.0,36692988,44401.0,1623363,5829,0.36
China,106526,4848,0,101678,52,4.55,0.0,0.0,2809352660,38.0,105902,624,0.59
Colombia,4867761,123459,0,4744302,3132,2.54,0.0,0.0,99141018,49099.0,4838984,28777,0.59
Comoros,4038,147,0,3891,0,3.64,0.0,0.0,869595,4644.0,4031,7,0.17
Congo (Brazzaville),13356,179,0,13177,0,1.34,0.0,0.0,89561403,149.0,13216,140,1.06
Congo (Kinshasa),53254,1050,0,52204,118,1.97,0.0,0.0,5518087,9651.0,51889,1365,2.63
Costa Rica,428295,5211,0,423084,0,1.22,0.0,0.0,5094114,84076.0,416677,11618,2.79
Cote d'Ivoire,52202,359,0,51843,0,0.69,0.0,0.0,26378274,1979.0,51380,822,1.6
Croatia,367022,8283,0,358739,298,2.26,0.0,0.0,4105268,89403.0,365045,1977,0.54
Cuba,517668,4023,0,513645,8636,0.78,0.0,0.0,11326616,45704.0,458219,59449,12.97
Cyprus,108872,456,0,108416,165,0.42,0.0,0.0,1207361,90174.0,105982,2890,2.73
Czechia,1676222,30373,0,1645849,142,1.81,0.0,0.0,10708981,156525.0,1674906,1316,0.08
Denmark,332013,2562,0,329451,850,0.77,0.0,0.0,5897840,56294.0,324948,7065,2.17
Diamond Princess,712,13,0,699,0,1.83,0.0,0.0,0,37446.03125,712,0,0.0
Djibouti,11682,156,0,11526,6,1.34,0.0,0.0,988002,11824.0,11662,20,0.17
Dominica,943,0,0,943,367,0.0,0.0,0.0,71991,13099.0,367,576,156.95
Dominican Republic,346176,3980,0,342196,216,1.15,0.0,0.0,10847904,31912.0,344495,1681,0.49
Ecuador,493767,31870,0,461897,0,6.45,0.0,0.0,17643060,27986.0,491831,1936,0.39
Egypt,285358,16619,0,268739,101,5.82,0.0,0.0,102334403,2788.0,284706,652,0.23
El Salvador,90129,2789,0,87340,0,3.09,0.0,0.0,6486201,13895.0,88371,1758,1.99
Equatorial Guinea,8972,123,0,8849,0,1.37,0.0,0.0,1402985,6395.0,8951,21,0.23
Eritrea,6601,37,0,6564,0,0.56,0.0,0.0,3546427,1861.0,6576,25,0.38
Estonia,136992,1279,0,135713,202,0.93,0.0,0.0,1326539,103270.0,135076,1916,1.42
Eswatini,36008,934,0,35074,157,2.59,0.0,0.0,1160164,31037.0,31060,4948,15.93
Ethiopia,289274,4478,0,284796,486,1.55,0.0,0.0,114963583,2516.0,284091,5183,1.82
Fiji,39770,368,0,39402,0,0.93,0.0,0.0,896444,44364.0,36979,2791,7.55
Finland,117531,1003,0,116528,535,0.85,0.0,0.0,5540718,21212.0,112207,5324,4.74
France,6543099,112873,0,6430226,21172,1.73,0.0,0.0,68151730,96008.0,6371349,171750,2.7
Gabon,25564,165,0,25399,0,0.65,0.0,0.0,2225728,11486.0,25462,102,0.4
Gambia,9195,271,0,8924,275,2.95,0.0,0.0,2416664,3805.0,8603,592,6.88
Georgia,481578,6406,0,475172,4314,1.33,0.0,0.0,3989175,120721.0,447913,33665,7.52
Germany,3828278,91878,0,3736400,3732,2.4,0.0,0.0,166803158,22951.0,3797849,30429,0.8
Ghana,110710,922,0,109788,404,0.83,0.0,0.0,31072945,3563.0,108226,2484,2.3
Greece,537125,13191,0,523934,1888,2.46,0.0,0.0,10423056,51532.0,514192,22933,4.46
Grenada,180,1,0,179,0,0.56,0.0,0.0,112519,1600.0,178,2,1.12
Guatemala,413040,11155,0,401885,1309,2.7,0.0,0.0,17915567,23055.0,390514,22526,5.77
Guinea,28020,287,0,27733,183,1.02,0.0,0.0,13132792,2134.0,26847,1173,4.37
Guinea-Bissau,5123,90,0,5033,24,1.76,0.0,0.0,1967998,2603.0,4788,335,7.0
Guyana,23561,574,0,22987,106,2.44,0.0,0.0,786559,29955.0,22982,579,2.52
Haiti,20507,576,0,19931,0,2.81,0.0,0.0,11402533,1798.0,20326,181,0.89
Holy See,27,0,0,27,0,0.0,0.0,0.0,809,33375.0,27,0,0.0
Honduras,316235,8373,0,307862,0,2.65,0.0,0.0,9904608,31928.0,305936,10299,3.37
Hungary,810316,30038,0,780278,0,3.71,0.0,0.0,9660350,83881.0,809855,461,0.06
Iceland,9522,30,0,9492,64,0.32,0.0,0.0,341250,27903.0,8793,729,8.29
India,32225513,431642,0,31793871,32937,1.34,0.0,0.0,2751341248,11713.0,31969954,255559,0.8
Indonesia,3854354,117588,0,3736766,20813,3.05,0.0,0.0,273523621,14091.0,3666031,188323,5.14
Iran,4425821,97828,0,4327993,36736,2.21,0.0,0.0,83992953,52693.0,4158729,267092,6.42
Iraq,1775764,19672,0,1756092,7011,1.11,0.0,0.0,40222503,44149.0,1712709,63055,3.68
Ireland,324747,5059,0,319688,1758,1.56,0.0,0.0,4937796,65768.0,312465,12282,3.93
Israel,939360,6668,0,932692,4464,0.71,0.0,0.0,8655541,108527.0,900482,38878,4.32
Italy,4440669,128432,0,4312237,5661,2.89,0.0,0.0,120822834,36754.0,4396417,44252,1.01
Jamaica,57945,1300,0,56645,656,2.24,0.0,0.0,2961161,19568.0,54859,3086,5.63
Japan,1148743,15423,0,1133320,17902,1.34,0.0,0.0,252643406,4547.0,1032080,116663,11.3
Jordan,783448,10213,0,773235,1238,1.3,0.0,0.0,10203140,76785.0,777164,6284,0.81
Kazakhstan,760241,10791,0,749450,15103,1.42,0.0,0.0,18776707,40489.0,705327,54914,7.79
Kenya,220727,4340,0,216387,789,1.97,0.0,0.0,53771300,4105.0,211828,8899,4.2
Kiribati,2,0,0,2,0,0.0,0.0,0.0,117606,17.0,2,0,0.0
"Korea, South",225481,2167,0,223314,1553,0.96,0.0,0.0,51269183,4398.0,212448,13033,6.13
Kosovo,116247,2284,0,113963,1096,1.96,0.0,0.0,1793000,64834.0,109931,6316,5.75
Kuwait,406540,2389,0,404151,306,0.59,0.0,0.0,4270563,95196.0,403349,3191,0.79
Kyrgyzstan,172090,2446,0,169644,332,1.42,0.0,0.0,6524191,26377.0,169017,3073,1.82
Laos,10092,9,0,10083,198,0.09,0.0,0.0,7275556,1387.0,8392,1700,20.26
Latvia,140122,2561,0,137561,73,1.83,0.0,0.0,1886202,74288.0,139421,701,0.5
Lebanon,583012,7976,0,575036,1515,1.37,0.0,0.0,6825442,85417.0,571650,11362,1.99
Lesotho,14243,397,0,13846,0,2.79,0.0,0.0,2142252,6649.0,13603,640,4.7
Liberia,5459,148,0,5311,0,2.71,0.0,0.0,5057677,1079.0,5459,0,0.0
Libya,281930,3904,0,278026,2831,1.38,0.0,0.0,6871287,41030.0,267846,14084,5.26
Liechtenstein,3155,59,0,3096,9,1.87,0.0,0.0,38137,82728.0,3101,54,1.74
Lithuania,289810,4451,0,285359,464,1.54,0.0,0.0,2722291,106458.0,286103,3707,1.3
Luxembourg,74595,828,0,73767,0,1.11,0.0,0.0,625976,119166.0,74262,333,0.45
MS Zaandam,9,2,0,7,0,22.22,0.0,0.0,0,37446.03125,9,0,0.0
Madagascar,42811,952,0,41859,0,2.22,0.0,0.0,27691019,1546.0,42776,35,0.08
Malawi,58083,1968,0,56115,187,3.39,0.0,0.0,19129955,3036.0,55920,2163,3.87
Malaysia,1404899,12510,0,1392389,20546,0.89,0.0,0.0,32365998,43407.0,1262540,142359,11.28
Maldives,79137,222,0,78915,137,0.28,0.0,0.0,540542,146403.0,78356,781,1.0
Mali,14695,535,0,14160,3,3.64,0.0,0.0,20250834,726.0,14642,53,0.36
Malta,35337,430,0,34907,51,1.22,0.0,0.0,441539,80031.0,34846,491,1.41
Marshall Islands,4,0,0,4,0,0.0,0.0,0.0,58413,68.0,4,0,0.0
Mauritania,30121,640,0,29481,237,2.12,0.0,0.0,4649660,6478.0,28197,1924,6.82
Mauritius,5607,21,0,5586,0,0.37,0.0,0.0,1271767,4409.0,4592,1015,22.1
Mexico,3091971,248167,0,2843804,0,8.03,0.0,0.0,255584572,12098.0,2971817,120154,4.04
Micronesia,1,0,0,1,0,0.0,0.0,0.0,113815,9.0,1,0,0.0
Moldova,262044,6308,0,255736,97,2.41,0.0,0.0,4033963,64959.0,260630,1414,0.54
Monaco,3059,33,0,3026,1,1.08,0.0,0.0,39244,77948.0,2974,85,2.86
Mongolia,182591,876,0,181715,1300,0.48,0.0,0.0,3278292,55697.0,174603,7988,4.57
Montenegro,106196,1644,0,104552,446,1.55,0.0,0.0,628062,169085.0,103722,2474,2.39
Morocco,759456,11017,0,748439,7380,1.45,0.0,0.0,36910558,20576.0,696282,63174,9.07
Mozambique,138749,1716,0,137033,405,1.24,0.0,0.0,31255435,4439.0,132452,6297,4.75
Namibia,122469,3277,0,119192,242,2.68,0.0,0.0,2540916,48199.0,121043,1426,1.18
Nepal,732272,10292,0,721980,1793,1.41,0.0,0.0,29136808,25132.0,714877,17395,2.43
Netherlands,1934759,18218,0,1916541,2398,0.94,0.0,0.0,34882427,55465.0,1917056,17703,0.92
New Zealand,2927,26,0,2901,7,0.89,0.0,0.0,4839692,605.0,2891,36,1.25
Nicaragua,10251,197,0,10054,0,1.92,0.0,0.0,6624554,1547.0,9853,398,4.04
Niger,5724,196,0,5528,2,3.42,0.0,0.0,24206636,236.0,5687,37,0.65
Nigeria,182503,2219,0,180284,541,1.22,0.0,0.0,399640130,457.0,178086,4417,2.48
North Macedonia,162164,5552,0,156612,805,3.42,0.0,0.0,2083380,77837.0,158025,4139,2.62
Norway,144484,808,0,143676,449,0.56,0.0,0.0,5421242,26651.0,140836,3648,2.59
Oman,300194,3993,0,296201,552,1.33,0.0,0.0,5106622,58785.0,298706,1488,0.5
Pakistan,1102079,24478,0,1077601,3669,2.22,0.0,0.0,428724125,2571.0,1071620,30459,2.84
Palau,0,0,0,0,0,0.0,0.0,0.0,18008,0.0,0,0,0.0
Panama,447824,6951,0,440873,563,1.55,0.0,0.0,4314768,103789.0,442295,5529,1.25
Papua New Guinea,17806,192,0,17614,0,1.08,0.0,0.0,8947027,1990.0,17774,32,0.18
Paraguay,456695,15439,0,441256,106,3.38,0.0,0.0,7132530,64030.0,455120,1575,0.35
Peru,2133812,197393,0,1936419,978,9.25,0.0,0.0,65597846,32529.0,2125345,8467,0.4
Philippines,1741616,30340,0,1711276,14385,1.74,0.0,0.0,109581085,15893.0,1658916,82700,4.99
Poland,2885333,75299,0,2810034,148,2.61,0.0,0.0,76257753,37837.0,2884098,1235,0.04
Portugal,1003335,17562,0,985773,2217,1.75,0.0,0.0,10196707,98398.0,986967,16368,1.66
Qatar,229168,601,0,228567,187,0.26,0.0,0.0,2881060,79543.0,227689,1479,0.65
Romania,1087223,34348,0,1052875,323,3.16,0.0,0.0,19237682,56515.0,1084919,2304,0.21
Russia,6511431,167595,0,6343836,21010,2.57,0.0,0.0,292579178,22255.0,6362641,148790,2.34
Rwanda,79702,959,0,78743,418,1.2,0.0,0.0,12952209,6154.0,76091,3611,4.75
Saint Kitts and Nevis,655,3,0,652,13,0.46,0.0,0.0,53109,12333.0,614,41,6.68
Saint Lucia,6366,95,0,6271,79,1.49,0.0,0.0,183629,34668.0,5837,529,9.06
Saint Vincent and the Grenadines,2314,12,0,2302,6,0.52,0.0,0.0,110854,20874.0,2299,15,0.65
Samoa,3,0,0,3,0,0.0,0.0,0.0,196130,15.0,3,0,0.0
San Marino,5194,90,0,5104,0,1.73,0.0,0.0,33938,153044.0,5147,47,0.91
Sao Tome and Principe,2488,37,0,2451,0,1.49,0.0,0.0,219159,11352.0,2470,18,0.73
Saudi Arabia,537374,8388,0,528986,0,1.56,0.0,0.0,34813867,15436.0,531935,5439,1.02
Senegal,70679,1600,0,69079,266,2.26,0.0,0.0,16743930,4221.0,67579,3100,4.59
Serbia,732044,7167,0,724877,817,0.98,0.0,0.0,8737370,83783.0,725702,6342,0.87
Seychelles,18895,98,0,18797,0,0.52,0.0,0.0,98340,192140.0,18582,313,1.68
Sierra Leone,6342,121,0,6221,4,1.91,0.0,0.0,7976985,795.0,6315,27,0.43
Singapore,66172,44,0,66128,53,0.07,0.0,0.0,5850343,11311.0,65764,408,0.62
Slovakia,393529,12544,0,380985,74,3.19,0.0,0.0,5459643,72080.0,393040,489,0.12
Slovenia,261428,4433,0,256995,95,1.7,0.0,0.0,2078932,125751.0,260109,1319,0.51
Solomon Islands,20,0,0,20,0,0.0,0.0,0.0,652858,31.0,20,0,0.0
Somalia,16319,883,0,15436,54,5.41,0.0,0.0,15893219,1027.0,15865,454,2.86
South Africa,2605586,77141,0,2528445,10139,2.96,0.0,0.0,59308690,43933.0,2533466,72120,2.85
South Sudan,11172,120,0,11052,0,1.07,0.0,0.0,11193729,998.0,11100,72,0.65
Spain,4693540,82470,0,4611070,0,1.76,0.0,0.0,93691843,50096.0,4588132,105408,2.3
Sri Lanka,354968,6096,0,348872,3435,1.72,0.0,0.0,21413250,16577.0,329994,24974,7.57
Sudan,37543,2813,0,34730,0,7.49,0.0,0.0,43849269,856.0,37138,405,1.09
Summer Olympics 2020,542,0,0,542,9,0.0,0.0,0.0,0,37446.03125,409,133,32.52
Suriname,26593,683,0,25910,54,2.57,0.0,0.0,586634,45332.0,26002,591,2.27
Sweden,1110147,14658,0,1095489,0,1.32,0.0,0.0,20426859,54347.0,1104538,5609,0.51
Switzerland,735375,10924,0,724451,0,1.49,0.0,0.0,8654618,84969.0,723968,11407,1.58
Syria,26342,1937,0,24405,50,7.35,0.0,0.0,17500657,1505.0,26097,245,0.94
Taiwan*,15852,821,0,15031,9,5.18,0.0,0.0,23806638,666.0,15782,70,0.44
Tajikistan,16061,123,0,15938,0,0.77,0.0,0.0,9537642,1684.0,15651,410,2.62
Tanzania,1367,50,0,1317,0,3.66,0.0,0.0,59734213,23.0,1017,350,34.41
Thailand,907157,7552,0,899605,21882,0.83,0.0,0.0,69799978,12997.0,756505,150652,19.91
Timor-Leste,12565,30,0,12535,293,0.24,0.0,0.0,1318442,9530.0,11529,1036,8.99
Togo,18000,165,0,17835,419,0.92,0.0,0.0,8278737,2174.0,16874,1126,6.67
Trinidad and Tobago,41866,1180,0,40686,190,2.82,0.0,0.0,1399491,29915.0,40233,1633,4.06
Tunisia,623940,21827,0,602113,1678,3.5,0.0,0.0,11818618,52793.0,610660,13280,2.17
Turkey,6078623,53159,0,6025464,18847,0.87,0.0,0.0,84339067,72074.0,5895841,182782,3.1
US,36678753,621635,0,36057118,38482,1.69,0.0,0.0,330541757,110966.0,35763785,914968,2.56
Uganda,96987,2882,0,94105,309,2.97,0.0,0.0,45741000,2120.0,95723,1264,1.32
Ukraine,2355317,56159,0,2299158,1309,2.38,0.0,0.0,89634808,26277.0,2344260,11057,0.47
United Arab Emirates,701776,2001,0,699775,1189,0.29,0.0,0.0,9890400,70955.0,692964,8812,1.27
United Kingdom,6297157,131269,0,6165888,26484,2.08,0.0,0.0,134862019,46693.0,6098117,199040,3.26
Uruguay,383292,6003,0,377289,80,1.57,0.0,0.0,3473727,110340.0,382506,786,0.21
Uzbekistan,143041,976,0,142065,917,0.68,0.0,0.0,33469199,4274.0,136635,6406,4.69
Vanuatu,4,1,0,3,0,25.0,0.0,0.0,292680,14.0,4,0,0.0
Venezuela,319094,3799,0,315295,909,1.19,0.0,0.0,28435943,11222.0,312115,6979,2.24
Vietnam,275044,5774,0,269270,9580,2.1,0.0,0.0,97338583,2826.0,215560,59484,27.6
West Bank and Gaza,320034,3623,0,316411,0,1.13,0.0,0.0,4543126,70444.0,317999,2035,0.64
Yemen,7293,1403,0,5890,20,19.24,0.0,0.0,29825968,245.0,7165,128,1.79
Zambia,202261,3529,0,198732,183,1.74,0.0,0.0,18383956,11002.0,200049,2212,1.11
Zimbabwe,120088,4109,0,115979,235,3.42,0.0,0.0,14862927,8080.0,116327,3761,3.23
